15 17
#################
#c=)))=d#ab....W#
#..-)-..#.......#
#.......#.--.--.#
#...W...#.-)))-.#
#=.=.=.=#.-----.#
#W.....W#W.....W#
##=--=####-==-###
#.......#f......#
#.......=.......#
#...e...-...====#
#.......-...====#
#--...--=...==WW#
#)))))))#...==WW#
#################