14 17
#################
#W-#.)######...)#
#--...##RF.#...W#
#.....##........#
##.)..#.).......#
##R#..-......)..#
####..-....F##..#
##)...-.....##..#
##....-.).=..#..#
#=....-...-..#b.#
##...........#==#
#----....#=-=#==#
#a.)#)##c.-)-#))#
#################