7 8
########
#R)#..F#
#W..).=#
#--==.)#
#).....#
#a..#.b#
########