14 17
#################
#W-#.)######...)#
#--...##RF.#...W#
#.....##........#
##.)..#.).......#
##R#..-.......a.#
####..-....F##..#
##)...-.....##..#
##....-.).=..#..#
#=....-...-..#..#
##...........#==#
#----....#=-=#==#
#b.)#)##c.-)-#))#
#################
